A	AH
A(2)	EY
CAN	K AE N
CAN(2)	K AH N
CURRENT	K ER AH N T
CURRENT(2)	K ER N T
CURRENT(3)	K AA R AH N T
DESCRIBE	D IH S K R AY B
FACE	F EY S
FRONT	F R AH N T
HELLO	HH AH L OW
HELLO(2)	HH EH L OW
HELP	HH EH L P
IN	IH N
IS	IH Z
ME	M IY
NEWS	N UW Z
NEWS(2)	N Y UW Z
OF	AH V
SAVE	S EY V
SEARCH	S ER CH
SHUTDOWN	SH AH T D AW N
TELL	T EH L
THE	DH AH
THE(2)	DH IY
THIS	DH IH S
TIME	T AY M
VIEW	V Y UW
WEATHER	W EH DH ER
WHAT	W AH T
WHAT(2)	HH W AH T
WHO	HH UW
WIKIPEDIA	W IH K IY P IY D IY AH
YOU	Y UW